20 //ancho
*
12	//alto
*
0,1
*
00:0:26 //catalogo de sprites
#
01:0:108
#
02:0:63
#
03:0:72
#
04:0:110
#
05:0:57
#
06:0:83
#
07:0:49
*
55555555555555555555 //colisiones [0-no][x>0-si]
00000222222222222000
00000222222222222067
00000222222222222040
00000000000000000040
00000000000000000040
00000333330000000040
00000333330000000040
00000333330000000040
00000333330000000040
00000333330000000040
00000000000000000040
*
05 05 05 05 05 05 05 05 05 05 05 05 05 05 05 05 05 05 05 05 	//mapa en sprites
 01 01 01 00 00 02 02 02 02 02 02 02 02 02 02 02 02 00 00 00
 01 01 01 00 00 02 02 02 02 02 02 02 02 02 02 02 02 00 06 07
 01 01 01 00 00 02 02 02 02 02 02 02 02 02 02 02 02 00 04 00
 01 01 01 00 00 00 00 00 00 00 00 00 00 00 00 00 00 00 04 00
 01 01 01 00 00 00 00 00 00 00 00 00 00 00 00 00 00 00 04 00
 01 01 01 00 00 03 03 03 03 03 00 00 01 01 01 01 01 00 04 00
 01 01 01 00 00 03 03 03 03 03 00 00 01 01 01 01 01 00 04 00
 01 01 01 00 00 03 03 03 03 03 00 00 01 01 01 01 01 00 04 00
 01 01 01 00 00 03 03 03 03 03 00 00 01 01 01 01 01 00 04 00
 01 01 01 00 00 03 03 03 03 03 00 00 01 01 01 01 01 00 04 00
 01 01 01 00 00 00 00 00 00 00 00 00 00 00 00 00 00 00 04 00
*
1-1 //spawn
*
11-1-zone1.map //despawn


