21
*
12
*
0,1
*
00:0:26
#
01:0:108
#
02:0:63
#
03:0:72
#
04:0:110
#
05:0:57
#
06:0:83
#
07:0:49
*
555555555555555555555
000002222222222220000
000002222222222220067
000002222222222220040
000000000000000000040
000000000000000000040
000003333300000000040
000003333300000000040
000003333300000000040
000003333300000000040
000003333300000000040
000000000000000000040
*
05 05 05 05 05 05 05 05 05 05 05 05 05 05 05 05 05 05 05 05 05
 01 01 01 00 00 02 02 02 02 02 02 02 02 02 02 02 02 00 00 00 00
 01 01 01 00 00 02 02 02 02 02 02 02 02 02 02 02 02 00 00 06 07
 01 01 01 00 00 02 02 02 02 02 02 02 02 02 02 02 02 00 00 04 00
 01 01 01 00 00 00 00 00 00 00 00 00 00 00 00 00 00 00 00 04 00
 01 01 01 00 00 00 00 00 00 00 00 00 00 00 00 00 00 00 00 04 00
 01 01 01 00 00 03 03 03 03 03 00 00 01 01 01 01 01 00 00 04 00
 01 01 01 00 00 03 03 03 03 03 00 00 01 01 01 01 01 00 00 04 00
 01 01 01 00 00 03 03 03 03 03 00 00 01 01 01 01 01 00 00 04 00
 01 01 01 00 00 03 03 03 03 03 00 00 01 01 01 01 01 00 00 04 00
 01 01 01 00 00 03 03 03 03 03 00 00 01 01 01 01 01 00 00 04 00
 01 01 01 00 00 00 00 00 00 00 00 00 00 00 00 00 00 00 00 04 00
*
19-1
*
20-1-zone1.map


