20
*
12
*
0,1
*
00:0:26
#
01:0:108
#
02:0:63
#
03:0:72
#
04:0:102
#
05:0:57
#
06:0:65
#
07:0:49
*
55555555555555555555
00000222222222222000
76000222222222222000
06000222222222222000
06000000000000000000
06000000000000000000
06000333330000000000
06000333330000000000
06000333330000000000
06000333330000000000
06000333330000000000
06000000000000000000
*
05 05 05 05 05 05 05 05 05 05 05 05 05 05 05 05 05 05 05 05
 00 00 00 00 00 02 02 02 02 02 02 02 02 02 02 02 02 00 00 00
 07 06 00 00 00 02 02 02 02 02 02 02 02 02 02 02 02 00 00 00
 00 04 01 00 00 02 02 02 02 02 02 02 02 02 02 02 02 00 00 00
 00 04 01 00 00 00 00 00 00 00 00 00 00 00 00 00 00 00 00 00
 00 04 01 00 00 00 00 00 00 00 00 00 00 00 00 00 00 00 00 00
 00 04 01 00 00 03 03 03 03 03 00 00 01 01 01 01 01 00 00 00
 00 04 01 00 00 03 03 03 03 03 00 00 01 01 01 01 01 00 00 00
 00 04 01 00 00 03 03 03 03 03 00 00 01 01 01 01 01 00 00 00
 00 04 01 00 00 03 03 03 03 03 00 00 01 01 01 01 01 00 00 00
 00 04 01 00 00 03 03 03 03 03 00 00 01 01 01 01 01 00 00 00
 00 04 01 00 00 00 00 00 00 00 00 00 00 00 00 00 00 00 00 00
*
1-1
*
0-1-zone2.map



